-------------
| W | Y | N |
-------------
| T | J | E |
-------------
| * | S | I |
-------------
